11111111111111111111
1C000000000000000001
10001111111111100001
10C01000000000100001
10001001111110100001
1P0010000000010000E1
10001000111110111111
1C001000100000000001
10001111110001100001
1C000000000000C00001
11111111111111111111
