111111111111111111111111111
1C0000000000000000000000001
1X0011111111111111111110001
100010000000000000CCCC10001
1XX010111111111011111010001
1P00000000000X00000000000E1
1XX010111111111111111010001
100010000000000000000010001
100011111111111111111110001
1C0000000000000000000000001
111111111111111111111111111